General Tags
Tag	Icon Name (Heroicons)	Icon Name (Lucide)
networking	UserGroupIcon	Users
workshop	Cog6ToothIcon	Tool
conference	PresentationChartBarIcon	Presentation
meetup	ChatBubbleLeftEllipsisIcon	MessageSquare
webinar	ComputerDesktopIcon	Monitor
training	AcademicCapIcon	GraduationCap
hackathon	CodeBracketIcon	Code
tech-talk	MicrophoneIcon	Mic
panel-discussion	ChatBubbleOvalLeftEllipsisIcon	MessageCircle
Professional Categories
Tag	Icon Name (Heroicons)	Icon Name (Lucide)
technology	CpuChipIcon	Cpu
business	BriefcaseIcon	Briefcase
marketing	MegaphoneIcon	Speaker
finance	BanknotesIcon	DollarSign
design	PencilIcon	PenTool
leadership	LightBulbIcon	Crown
entrepreneurship	ChartBarIcon	TrendingUp
Social Categories
Tag	Icon Name (Heroicons)	Icon Name (Lucide)
community	UsersIcon	People
charity	HeartIcon	Heart
education	BookOpenIcon	Book
wellness	FaceSmileIcon	Smile
arts	PhotoIcon	Brush
culture	GlobeAltIcon	Globe
sports	PlayIcon	Football
Popular Trends
Tag	Icon Name (Heroicons)	Icon Name (Lucide)
AI	ChipIcon	Robot
blockchain	CubeIcon	Layers
cybersecurity	ShieldCheckIcon	Shield
startups	RocketLaunchIcon	Rocket
cloud-computing	CloudIcon	Cloud
web-development	GlobeAltIcon	Code
data-science	ChartPieIcon	PieChart